#####
#.=.#
#%#o#
#.\.#
#####
